NO 11

111 11111
11011100111
10000000000
10000000011
10000000001
 110000001
11 110N001
11  110111
10111 1011
11111 1111

111 11111
11011100111
1000000000 1
10000000011
10000000001
 110000001
11 110N001
11  110111
10111 1011
11111 1111
