NO ../pics/este.xpm 
SO ../pics/oeste.xpm
EA ../pics/colorstone.xpm 
WE ../pics/bluestone.xpm 

C 50,185,255
F 140,115,70 

111111111111111
1000000000000001
1000000000000001
1000101111100001
1000000000000001
1000000000000001
10000000000000001
101000000000000001
1000000N000000001
1000000000000001
1000000000000001
1000000000000101
1000000000000001
1000000000000001
1000000000000001
1100000000000001
 11111111111111


