11111111111111
10000000000001
10000000000001
10001111110001
10000000000001
100000N0000001
11111111111111
