NO ../pics/mossy.xpm 
SO ../pics/greystone.xpm
EA ../pics/colorstone.xpm 
WE ../pics/bluestone.xpm 

C 225,30,0    
F 220,100,0

11111111111111
100000000000001
100000000000001
 110011111100001
1000001 100000001
1000000101000011
100000001000001
10000000000001111   1
1000111000000000011101
10000011000000001   1
 111111111011111
         1N1
          1
