NO ../pics/mossy.xpm 
SO ../pics/greystone.xpm
EA ../pics/colorstone.xpm 
WE ../pics/bluestone.xpm 

C 225,30,0    
F 220,100,0

111111111111111
1000000000000001
1000000000000001
1000101111100001
1000000000100001
1000000000000001
10000000000000001
10100E000000000001
10000000000000001
1000000000000001
1000000000000001
1000000000000101
1000000000000001
1100000000000001
 11111111111111
