111111111111111
100000000000001
100000000000001
1E0011111110001
100000000000001
1000000N0000001
111111111111111
