NO ../pics/mossy.xpm
SO ../pics/greystone.xpm
EA ../pics/colorstone.xpm
WE ../pics/bluestone.xpm

C 50,185,255
F 140,115,70

11111111111    111111111111
 10000000001   1000000000001
1000000000001111000001001001
 100000000000110000001001001
111111000000010000001001001
100000000000000000010010001
110000010000000000001001001
1100001 1000001111111001001
1000000100000100001001001001
100000010000000000000000001
100000000000000000000000001
100000000000000000000000001
100000000000000000000000001
100000000000000000000000001
1000000000000N000000000001
1000000000000000111111111
1000010000000001
100011100000001
11111111111111






