NO 11

 1111 11111 
11001110111
 1000011001
1100001010011
11010011101
 11100N001
11 11000001
11  110111
1111 11001
111 111111
