NO 11

 111 11111 
11011100011
1000110000111   
101001110001
111001110001
 111000001111
11 11000001 
11  1101111
1111100E001
 111111111111