NO 11

 111 11111 
11011100011
10001100001111
101001110001
111011110001
  1110000011
 11 11000001
11  11011111
1111100E001
 111111111111
