NO 11

 111 01111
11011100111
 1000011001
1100001 10011
10010001001
 110000001
11 11000001
11  110111
10111010N1
111 111111
